1111111111111111111111111
1000000000000010000000001
100100000C0001C10C1110C01
100111110000011100000C101
1E0011000P110001001C10001
1010000000000111000000001
1000000000000111000000001
1C0000C000000111000000C01
1111111111111111111111111