11111111111111111
11P00000000C00001
1111110C111111111
11111101111111111
11111000C11111111
11110C01111111111
10000000000C00001
111111111111100C1
1E0000000C000C001
11111111111111111
